..F-7....
..|.|..S7
F-J.L-7||
|.....|||
L-7F--J||
..||...||
..|L---J|
..L-----J