.........
.F--S--7.
.|.....|.
.L---7.|.
.F-7.|.|.
.|.|.|FJ.
.|.L-J|..
.L----J..