........
.F-S--7.
.|....|.
.L--7.|.
.F-7|.|.
.|.||FJ.
.|.LJ|..
.L---J..