.........
.S-----7.
.|.F-7.|.
.|.J.L-J.
.|.L-7...
.L---J...